CSA = "countries/Confederate States of America.txt"
CAL = "countries/California.txt"
DES = "countries/Deseret.txt"
MAN = "countries/Manhattan.txt"
CAR = "countries/Caribbean Federation.txt"
BYZ = "countries/Byzantium.txt"
SCA = "countries/Scandinavia.txt"
NWS = "countries/New West Seaxe.txt"
ROS = "countries/Republic of Senses.txt"
NRM = "countries/Northumbria.txt"
ARI = "countries/Emirate of Arabia.txt"
NOV = "countries/Novgrod Republic.txt"
NEA = "countries/New East Anglia.txt"
CGE = "countries/Carthage.txt"
ICA = "countries/Incan Empire.txt"
TCU = "countries/Transcaucasian Union.txt"
GTR = "countries/Genoan Trade Republic.txt"
MLI = "countries/Mali.txt"
POM = "countries/Pomerania.txt"
OCC = "countries/Occitania.txt"
BLK = "countries/Belitkal.txt"
GUJ = "countries/Gujrat.txt"
IND = "countries/Indochina.txt"
CSK = "countries/Cossack Federation.txt"
KMK = "countries/Kamchatka Krai.txt"
SIC = "countries/Sicily.txt"
WAL = "countries/Wales.txt"
NJO = "countries/North Joseon.txt"
EKN = "countries/Eurasian Khanate.txt"
KOL = "countries/Kingdom of Loango.txt"
GUY = "countries/Guyana.txt"
RUT = "countries/Ruthenia.txt"
NVZ = "countries/Nuova Venezia.txt"
INV = "countries/Martian Horde.txt"
